NO ./srcs/texture/z2.png
SO ./srcs/texture/z3.png
WE ./srcs/texture/z4.png
EA ./srcs/texture/z1.png

F 0,120,0
C 0,0,120

1
111111
1010001111
10S0001011
1000010D11
1110000011
111111111