NO ./srcs/texture/z2.png
SO ./srcs/texture/z3.png
WE ./srcs/texture/z4.png
EA ./srcs/texture/z1.png

F 0,120,0
C 0,0,120

1
111111
101001
10N0011
100001
111111