NO ./srcs/texture/z2.png
SO ./srcs/texture/z3.png
WE ./srcs/texture/z4.png
EA ./srcs/texture/z1.png

F 0,120,0
C 0,0,120

1
1111111  111
101000111101
10S0001011011
1000010111001
111000DD00101
1111111100D01
       111101
        11111 