
NO ./srcs/texture/z2.png
SO ./srcs/texture/z3.png
WE ./srcs/texture/z4.png
EA ./srcs/texture/z1.png

F 0,120,0
C 0,0,120

1111111111111111111111111111111111111
1011000000000000000000000000000000001
1001000000000000000000000000000000001
1001100000000000000000000000000000001
1000000000010000000000000000000000001
1111100000010000000W00000000000000001
1000000000010000000000000000000000001
1001000000000000000000000000100000001
1000000000000000000000000001100000001
1111000000000000000000000000100000001
1011000000000011111000000000000000001
1011000000000000000000000000000000001
1011000000100000000011000000000000001
1011000000100000000000000000000000001
101100000010DDDDDDD000000000000000001
101100000010DDDDDDD000000000000000001
101100000010DDDDDDD000000000000000001
101100000010DDDDDDD000000000000000001
1011000000100000000000000000000000001
1011000000100011111000000000000000001
1011000000100011111000000000000000001
1011000000100011111000000000000000001
1011000000000000010000000000000000001
1011000000000000010000000000000000001
1011000000000000001000000000000000001
1011000000000000000010000000000000001
1011000000000000001000000000000000001
1011000000000000000000000000000000001
1011000000000000000000000000000000001
1011000000000000000000000000000000001
1011000000000000000000000000000000001
1011000000000000000000000000000000001
1011000000000000000000000000000000001
1011000000000000000000000000000000001
1011000000DD0000000000000000000000001
1011000000000000000000000000000000001
10110000DD000000000000000000000000001
101100000000000000000000DD00000000001
1111111111111111111111111111111111111
